11111111111111111
1P100000000000001
10100000000100001
101C000000C100001
101000111111C0001
10C0001C000000001
10000C1E000000001
11111111111111111