1111111
1P00001
10000E1
100C001
1111111
